power - n.전력, 전기
device - n.장치
damaged - a.손상된, 손해를 입은
tailored - a.맞춤의, 주문에 따라 맞춘
shortage - n.부족
utilize - v.이용하다, 활용하다
respectively - ad.각각, 따로
capacity - n.용량,수용력; 역할
renovate - v.(가구 등을)개조하다, 수리하다, 보수하다
operate - v.작동하다, 움직이다
component - n.부품, (구성)요소
expiration - n.만료, 만기
machinery - n.기계류, 기계장치
processing - n.가공, 처리(cf.progress - 진전, 나아가다)
watering can - phr.물뿌리개
specification - n.명세서, 설명서, 사양
material - n.재료, 물질
limit - n.제한, 한계
success - n.성공, 성과 (cf.succeed-성공)
comparable - a.필적하는, 비교되는
prevent - v.~을 막다, ~을 예방하다
produce - v.생산하다
precaution - n.예방 조치, 예방책
facility - n.시설
cyclist - n.자전거 타는 사람
a number of - phr.많은
firewood - n.장작
separetely - ad.개별적으로, 따로따로
assemble - v.(부품 등을)조립하다; (사람을) 모으다
properly - ad.제대로, 정확하게
incredible - a.놀라운, 믿기 어려운
fasten - v.매다, 잠그다
automate - v.자동화하다
place - v.~을 -한 상태에 두다; (주문을)하다
efficiency - n.효율, 능력
curved - a.구부러진, 곡선 모양의
not far from - phr.~에서 멀지 않은
look up - phr.~을 찾다, 쳐다보다
raw material - phr.원자재 (raw - 익히지 않은, 날것의, 원자재의, 가공되지 않은)
equipment - n.장비, 설비
launch - v.(신제품을)출시하다
safety - n.안전
iron - n.철; v.다리미질을 하다
economize - v.절약하다, 아끼다
not at all - phr.전혀~아니다, 천만에
manufacturing - a.제조(업)의
flexible - a.융통성 있는; 유연한, 잘 구부러지는
craft - n.기술, 공예; v.공들여 만들다(=fashion)
clothing line - phr.의류 상품
crop - n.농작물, 산출량; v.아주 짧게 깎다
trim - v.(깎아)다듭다, 없애다; 삭감하다
maneuver - v.이동시키다, 움직이다; n.책략, 술책
decision - n.결정, 판단
rank - n.계급, 순위; v.등급을 매기다
capable - a.~을 할 수 있는, ~할 능력이 있는
undergound - a.지하의, 비밀의
scratch - v.긁다
be made up of - phr. ~으로 구성되다
plant - n.실물, 공장; v.(식물을)심다
be filled with - phr.~으로 채워지다
be composed of - phr.~으로 구성되다
attribute - v.(원인을)~의 덕분으로 돌리다 
coming - a.다가오는
publication company - phr.출판회사
modification - n.변경, 수정
tool belt - phr.공구 벨트
fill - v.~을 채우다; 이행하다
chemical - n.화학 제품, a.화학의
