resume - n.이력서 v.재개하다, 다시시작하다, 자기 위치로 돌아가다
opening - n.공석, 결원; 개장, 개시
applicant - n.지원자, 신청자
requirement - n.필요조건, 조건
meet - v(필요, 요구 등을)만족시키다
qulified - a.적격의, 자격있는
candidate - n. 후보자, 지원자
confidence - n.확신, 자신; 신임, 신뢰
highly - ad.매우, 대단히
professional - a.전문적인, 직업의; n.전문가
interview - n.면접; v.면접을 보다
hire  - v.고용하다
training  - n.훈련
reference - n.추천서;참고
position - n.일자리, 직책;위치, 자리 v.두다, 배치하다
achievement - n.성취, 달성
impressed - ad.인상 깊게 생각하는, 감명을 받은
excellent - a.훌륭한, 탁월한
eligible - a.자격이 있는, 적격의
identify - v.알아보다, 확인하다
associate - v.관련시키다, 연관짓다, 연상하다, 어울리다
condition - n.조건
employment - n.고용
lack - n.부족, v.~이 없다.
managerial - a.관리의, 경영의
diligent - a.성실한, 근면한
familiar - a.친숙한, 익숙한
proficiency - n.숙달, 능숙
prospective - a.장래의, 미래의
appeal - v.관심(흥미)을 끌다, 매력적이다.; n.매력 cf)appear-나타나다
specialize - v.~을 전공하다, 전문적으로 다루다
apprehensive - a.걱정하는, 염려하는
cosultant - n.고문, 컨설턴트
entitle - v.자격을 주다, 제목을 붙이다
degree - n.학위, 정도
payroll - n.임금대장, 급료명부,급여대상명단
recruit - v.(신입사원 등을)모집하다
certification - n.증명서, 증명
occupation - n.직업 (=job, work, career, profession)
wage - n.임금, 급료(=pay)
application form  - phr.신청서
career - n.직업, 경력
completion - n.완료, 완성
fair - a.공정한; n.박람회
graduation - n.졸업
in fact - phr.사실은
job fair - phr.취업 박람회
job offer - phr.일자리 제안
list - n.목록, 명단; v.목록에 기입하다.
newcomer - n.신입사원, 새로 온 사람
part-time - a.시간제의, 파트타임의
previous job - phr.이전 직업
secretary - n.비서, 총무
send in - phr.~을 제출하다
tidy - a.깔끔한, 단정한, v.정리하다
trainee - n.훈련받는 사람
apply for - phr.~에 지원하다
aptitude - n.재능, 소질
be admitted to - phr.~에 입장이 허용되다.
be advised to do - pht.~할 것을 권유받다.
criteria - n.기준(criterion의 복수형)
decade - n.10년
employ - v.고용하다
incorporated - a.법인 조직의
insufficient - a.불충분한
minimum - a.최소한의, n.최소한도
plentiful - a.풍부한
profession - n.직업