attire - n.복장, 옷차림새
code - n.규범, 관례; 암호
concern - n.우려,걱정; 문제, 일;v.~을 걱정스럽게 하다; 영향을 미치다
policy - n.규정; 보험증권
comply - v.준수하다, 따르다
regulation - n.규정
exception - n.예외
adhere - v.지키다, 고수하다
severely - ad.엄격하게, 심하게
refrain - v.자제하다, 삼가다
permission - n.허락, 허가
access - n.이용권한; 통로; v.~에 접근하다
thoroughly - ad.철저하게, 완전히, 대단히
revise - v.수정하다, 변경하다
approach - n.접근법, 처리방법; v.다가오다
approval - n.승인, 인가
form - n.종류, 유형, 양식
immediately - ad.즉시, 곧
inspection - n.점검, 검사
arrangement - n.준비, 마련, 주선
procedure - n.절차
negative - a.부정적인, 비관적인
mandate - v.명령하다, 지시하다; n.권한, 명령
effect - n.(법률의)효력, 효과, 영향; v.결과로서 ~을 가져오다
drastically - ad.심하게, 과감하게, 철저하게
according to - phr.~에 따라
enable - v.(무엇을)가능하게 하다
standard - n.표준, 기준
constant - a.지속적인, 끊임없이 계속하는
act - n.법령, 결의서; 행위, 행동; v.결정하다, 판결을 내리다; 행동하다
compensation - n.보상금, 보상
ban - v.금지하다
obligation - n.의무, 책임
authorize - v.~을 인가하다, 권한을 부여하다
prohibit - v.금지하다
abolish - v.(제도, 법률 등을) 폐지하다
enforce - v.(법률을)시행하다, 집행하다
habit - n.습관, 버릇
legislation - n.법률, 법규
restrict - v.제한하다, 한정하다
bend over - phr.몸을 앞으로 숙이다
by oneself - phr.혼자 힘으로 (=on one's own)
date - n.날짜
get used to - phr.~에 익숙해지다
if it's okay with you - phr.당신만 괜찮다면
in case of - phr.~의 경우에는
in rows - phr.줄지어, 여러 줄로
item - n.항목
legal - a.법률의, 법률적인
let go - phr.놓아 주다
ruler - n.자
stop - v.멈추다
busy - a.바쁜
curriculum - n.교과 과정
dress - n.의복(=garment); v.옷을 차려입다
fine - n.벌금, 연체료
finish - v.끝내다, 완료하다
have a problem (in) ~ing - phr.~하는데 문제가 있다.
large - a.큰, 넓은
law firm - phr.법률 회사
loudly - ad.시끄럽게
plus - prep.~을 더한, ~을 더하여
protect - v.보호하다
seldom - ad.드물게, 좀처럼 ~않는
theft - n.절도
try - v.시도하다, 노력하다
witness - n.목격자, 증인
write - v.글씨를 쓰다, 저술하다