accustomed - a.익숙한
corporation - n.주식회사, 법인
demanding - a.요구가 많은
colleague - n.(직업상의)동료
division - n.부서, 분할, 분배, 나눗셈
request - v.요청하다, n.요청
efficiently - ad.효율적으로
manage - v.~을 경영하다, 가까스로 하다
submit - v.제출하다
directly - ad.곧바로
remind - v.~에게 상기시키다, 일깨우다
instruct - v.지시하다, 가르치다
deadline - n.마감일, 마감 시간
sample - n.견본, 표본, 샘플; v.시식하다, 시험하다
notify - v.~에게 통지하다, 알리다
perform - v.(일,과제,의무 등을)행하다, 실행하다
monitor - v.감독하다, 감시하다, 검토하다
deserve - v.~할 만하다, ~할 가치가 있다.
assignment - n.일, 임무, 과제
entire - a.전체의
release - v.발표하다, 공개하다; n.출시, 발매
extension - n.연장, 연기;(전화의) 내선
electronically - ad.컴퓨터로, 컴퓨터 통신망으로
attendance - n.출근, 출석
absolutely - ad.절대적으로, 완전히
delegate - v.(권한 등을)위임하다; n.대표
attentively - ad.주의깊게, 조심스럽게
supervision - n.감독
workshop - n.워크숍, 연수
draw - v.끌다, 끌어당기다
revision - n.수정, 개정
reluctantly - ad.마지못해, 꺼려하여
acquaint - v.~에게 숙지시키다, 잘 알게 하다
convey - v.(용건을)전달하다
check - v.검사하다, 조사하다; 확인하다
headquarters - n.본부
file - v.(서류를)정리하다, 철하다;(고소를)제기하다, 제출하다
oversee - v.감독하다
involved - a.관여하는, 관계된, 연루된
concentrate - v.집중하다, 집중시키다
a sheet of - phr.~한 장
business card - phr.명함
cartridge - n.(프린터 등의)잉크 카트리지
daily - a.매일의; ad.날마다, 매일
edit - v.편집하다, 수정하다
hand - n.손; v.건네주다
in order to do - phr.~하기 위해서
laptop - n.휴대용 컴퓨터
name tag - phr.명찰, 명패
on vacation - phr.휴가 중인
paper jam - phr.(복사기에서의)종이 걸림
paperwork - n.문서 작업
partition - n.칸막이, 분할
rush hour - phr.(출퇴근 시의)교통 혼잡 시간
section - n.부분, 구역
sheet - n.시트, 종이
tabletop - n.테이블 윗면
telephone call - phr.전화 통화
trash bin - phr.쓰레기통
upstairs - a.위층의; ad.위층으로, 위층에
as if - phr.마치~인듯이
as well as - phr.~에 더하여, 게다가
be aware of - phr.~을 알고 있다
be known as - phr.~으로 알려져 있다
be likely to - phr.~할 가능성이 있다
detail - n.세부사항
offering - n.제공된 것
on one's own - phr.혼자서, 혼자 힘으로