lax - a.(행동 등이)느슨한, 규율에 못 미치는
procrastinate - v.미루다, 꾸물거리다
combined - a.결합된, 합동의
accomplish - v.성취하다
voluntarily - ad.자발적으로
undertake - v.(일을)떠맡다
assume - v.사실이라 생각하다, 추정하다; (역할을)맡다
occasionally - ad.가끔, 때때로
employee - n.직원, 고용인
assist - v.돕다, 조력하다
satisfied - a.만족하는
manner - n.방식, 태도, 예의
responsible - a.책임이 있는, 책임져야 할
conduct - v.(업무 등을)수행하다
adjust - v.적응하다
personnel - n.(집합적)직원, 인원; 인사과
agree - v.동의하다
supervise - v.감독하다, 지도하다
coworker - n.동료, 협력자
direct - v.~에게 길을 안내하다, 가르쳐 주다; ~로 향하다(겨냥하다) a.직접적인; 직행(직통)의
confidential - a.기밀의, 내밀한
assign - v.배정하다, 할당하다
leading - a.선도적인, 일류의, 가장 중요한
formal - a.격식을 갖춘
remove - v.해임하다, 제거하다
collect - v.모으다, 수집하다
coordinate - v.조정하다
hardly - ad.거의~하지 않다
abstract - a.추상적인; 막연한
directory - n.주소록
accountable - a.책임이 있는
skillfully - ad.능숙하게, 솜씨있게
exclusive - a.독점적인; 배타적인
intention - n.의지, 의향
transform - v.바꾸다, 변모시키다
respectful - a.정중한, 존경하는
duplicate - n.사본; v.복사하다; (불필요한 것을)다시하다; a.똑같은, 꼭 닮은; 사본의
contrary - n.반대; a.반대의, (contrary to : ~와 상반되는); 적합하지 않은, 불리한
disturbing - a.충격적인, 불안감을 주는, 방해하는 (disturbance:방해,소란,장애;disturb:방해하다,건드리다,불안하게 만들다)
engage - v.관여하다, 종사하다
foster - v.촉진하다, 육성하다
neutrality - n.중립성, 중립
widely - ad.널리
bookcase - n.책장, 책꽂이
bookshelf - n.책꽂이
case - n.경우
central office - phr.중앙 사무실
copy machine - phr.복사기
fax - n.팩스
file folder - phr.서류철
greet - phr.~에게 인사하다, ~를 환영하다, 받아들이다; 들어오다
group - n.단체, 그룹
keypad - n.(전화, 계산기 등의)소형 키보드
knife - n.칼
log on to - phr.~에 로그인하다
online - a.인터넷에 접속된; ad.온라인으로
photocopier - n.복사기
photocopy - n.복사; v.복사하다
print out - phr.(프린터로)출력하다
right away - phr.즉시, 당장
spell - v.철자를 쓰다, 철자를 말하다
wrap - v.싸다, 감싸다
fold - v.접다
least - a.가장 작은, 가장 적은
paper - n.서류
planning - n.계획, 입안
post - v.붙이다, 공고하다
press the button - phr.버튼을 누르다
server - n.서빙하는 사람,(컴퓨터의) 서버
sotre opening - phr.개점, 개장
task - n.일, 직무